32
32
BBBBBBBBBBBBBBBBBBBBBBBBBBBBBBBB
BFFFFFFFBFFFFFFFFFFFFFFFFFFFFFFB
BFFFFFFFBFFFFFFFFFFFFFFFFFFFFFFB
BFFFFFFFBFFFFFFFFFFFFFFFFFFFFFFB
BFFFFFFFBFFFFFFFFFFFFFFFFFFFFFFB
BFFFFFFFBFFFFFFFFdFFFFFDFFFFFFFB
BFFFFFFFBFFFFFFFFdFFFFFDFFFFFFFB
BFFFFFFFBFFFFFFFFdFFFFFDFFFFFFFB
BFFFFFFFBFFFFFFFFFFFFFFFFFFFFFFB
BFFFFFFFBFFFFFFFFFFFFFFFFFFFFFFB
BFFFFFFFBFFFFFFFFFFFFFFWFFFFFFFB
BFFFFFFFBFFFFFFFFFFFFFFWFFFFFFFB
BFFFFFFFBFFFFFFFFFFFFFFWFFFFFFFB
BFFFFFFFBFFFFFFFFFFFFFFFFFFFFFFB
BFFFFFFFBFFFFFFFFFFFFFFFFFFFFFFB
BFFFFFFFBFFFFFFFFFFFFFFBFFFFFFFB
BFFFFFFFBFFFFFFFFFFFFFFBFFFFFFFB
BFFFFFFFBFFFFFFFFFFFFFFBFFFFFFFB
BFFFFFFFBFFFFFFFFFFFFFFBFFFFFFFB
BFFFFFFFBFFFFFFFFFFFFFFBWWWWWFFB
BFFFFFFFFFFFFFFFFFFFFFFBFFFFFFFB
BFFFFFFFFFFFFFFFFFFFFFFBFFFFFFFB
BFFFFFFFFFFFFFFFFFFFFFFBWWWFFFFB
BFFFFFFFFFFFFFFFFFFFFFFBWWFFFFWB
BFFFFFFFFFFFFFFFFFFFFFFBWFFFFWWB
BFFFFFFFFFFFFFFFFFFFFFFBFFFFWWWB
BFFFFFFFFFFFFFFFFFFFFFFBFFFWWWWB
BFFFFFFFFFFFFFFFFFFFFFFBFFWWWWWB
BFFFFFFFFFFFFFFFFFFFFFFBFFFFFFFB
BFFFFFFFFFFFFFFFFFFFFFFBFFFPFFFB
BFFFFFFFFFFFFFFFFFFFFFFBFFFFFFFB
BBBBBBBBBBBBBBBBBBBBBBBBBBBBBBBB
