7
18
16
BBBBBBBBBBBBBBBBBB
BFFFBFFFBFFFWFFFFB
BFPFFFFFFFFFFFFDFB
BFFFBFFFBFFFWFFFFB
BBBBBBRBBBWBBBBBBB
BFFFFFFcBFFFFFFFFB
BFFFFFFFBFFFFF0FFB
BFFBBFF0BFF0FFF0rB
BFFFFFFFBccFFFFFFB
B0FFFBBFBBBBBBBBBB
BcBFFFFFFFFWWFFFFB
BBBWWWWWWWFWWFFcFB
BcF9F9FFFFFWWFFCFB
BFBBBBFFFFFWWFFcFB
BFFFFDFDFFFWWFFFFB
BBBBBBBBBBBBBBBBBB