3
32
32
BBBBBBBBBBBBBBBBBBBBBBBBBBBBBBBB
BFFFFFFFBFFFFFFFFFFFFFFFFFFFFFFB
BFFFFFFFBFFFFFFFFFFFFFFFFFFFFFFB
BFFFFFFFBFFFFFFFFFFFFFFFFFFFFFFB
BFFFFFFFBFFFFFFFFFFFrgbyFFFFFFFB
BFFFFFFFBFFFFFFFFdFFFFFDFFFFFFFB
BFFFFFFFBFFFFFFFFdFFFFFFFFFFFFFB
BFFFFFFFBFFFFFFFFdFFFFFDFFFFFFFB
BFFFFFFFBFFFFFFFFFFFPFFFFFFFFFFB
BFFFFFFFBFFFFFFFFFFFFFFFFFFFFFFB
BFFFFFFFBFFFFFFFDDDFFFFWFFFFFFFB
BFFFFFFFBFFFFFFFFFFFFFFWFFFFFFFB
BFFFFFFFBFFFFFFFFFFFFFFWFFFFFFFB
BFFFFFFFBFFFFFFFcccFFFFFFFFFFFFB
BFFFFFFFBFFFFFFFFFFFFFFFFFFFFFFB
BFFFFFFFBFFFFFFFFFFFFFFBFFFFFFFB
BFFFFFFFBFFFRGAYFFFFFFFBFFFFFFFB
BFFFFFFFBFFFFFFFFFFFFFFBFFFFFFFB
BFFFFFFFBFFFFFFFFFFCFFFBFFFFFFFB
BFFFFFFFBFFFFFFFFFFFFFFBWWWWWFFB
BFFFFFFFFFFFFFFFFFFFFFFBFFFFFFFB
BFFFFFFFFFFFFFFFFFFFFFFBFFFFFFFB
BFFFFFFFFFFFFFFFFFFFFFFBWWWFFFFB
BFFFFFFFFFFFFFFFFFFFFFFBWWFFFFWB
BFFFFFFFFFFFFFFFFFFFFFFBWFFFFWWB
BFFFFFFFFFFFFFFFFFFFFFFBFFFFWWWB
BFFFFFFFFFFFFFFFFFFFFFFBFFFWWWWB
BFFFFFFFFFFFFFFFFFFFFFFBFFWWWWWB
BFFFFFFFFFFFFFFFFFFFFFFBFFFFFFFB
BFFFFFFFFFFFFFFFFFFFFFFBFFFFFFFB
BFFFFFFFFFFFFFFFFFFFFFFBFFFFFFFB
BBBBBBBBBBBBBBBBBBBBBBBBBBBBBBBB
