7
300 
0
18
16
BL BL BL BL BL BL BL BL BL BL BL BL BL BL BL BL BL BL 
BL FF FF FF BL FF FF FF BL FF FF FF WA FF FF FF FF BL 
BL FF PS FF FF FF FF FF FF FF FF FF FF FF FF BD FF BL 
BL FF FF FF BL FF FF FF BL FF FF FF WA FF FF FF FF BL 
BL BL BL BL BL BL DR BL BL BL WA BL BL BL BL BL BL BL 
BL FF FF FF FF FF FF co BL FF FF FF FF FF FF FF FF BL 
BL FF FF FF FF FF FF FF BL FF FF FF FF FF B0 FF FF BL 
BL FF FF BL BL FF FF B0 BL FF FF B0 FF FF FF B0 kr BL 
BL FF FF FF FF FF FF FF BL co co FF FF FF FF FF FF BL 
BL B0 FF FF FF BL BL FF BL BL BL BL BL BL BL BL BL BL 
BL co BL FF FF FF FF FF FF FF FF WA WA FF FF FF FF BL 
BL BL BL WA WA WA WA WA WA WA FF WA WA FF FF co FF BL 
BL co FF V0 FF V0 FF FF FF FF FF WA WA FF FF CW FF BL 
BL FF BL BL BL BL FF FF FF FF FF WA WA FF FF co FF BL 
BL FF FF FF FF BD FF BD FF FF FF WA WA FF FF FF FF BL 
BL BL BL BL BL BL BL BL BL BL BL BL BL BL BL BL BL BL 