32
32
BBBBBBBBBBBBBBBBBBBBBBBBBBBBBBBB
BFFFFFFFBFFFFFFFFFFFFFFFFFFFFFFB
BFFFFFFFBFFFFFFFFFFFFFFFFFFFFFFB
BFFFFFFFBFFFFFFFFFFFFFFFFFFFFFFB
BFFFFFFFBFFFFFFFFFFFFFFFFFFFFFFB
BFFFFFFFBFFFFFFFFFFFFFFFFFFFFFFB
BFFFFFFFBFFFFFFFFFFFFFFFFFFFFFFB
BFFFFFFFBFFFFFFFFFFFFFFFFFFFFFFB
BFFFFFFFBFFFFFFFFFFFFFFFFFFFFFFB
BFFFFFFFBFFFFFFFFFFFFFFFFFFFFFFB
BFFFFFFFBFFFFFFFFFFFFFFFFFFFFFFB
BFFFFFFFBFFFFFFFFFFFFFFFFFFFFFFB
BFFFFFFFBFFFFFFFFFFFFFFFFFFFFFFB
BFFFFFFFBFFFFFFFFFFFFFFFFFFFFFFB
BFFFFFFFBFFFFFFFFFFFFFFFFFFFFFFB
BFFFFFFFBFFFFFFFFFFFFFFBFFFFFFFB
BFFFFFFFBFFFFFFFFFFFFFFBFFFFFFFB
BFFFFFFFBFFFFFFFFFFFFFFBFFFFFFFB
BFFFFFFFBFFFFFFFFFFFFFFBFFFFFFFB
BFFFFFFFBFFFFFFFFFFFFFFBFFFFFFFB
BFFFFFFFFFFFFFFFFFFFFFFBFFFFFFFB
BFFFFFFFFFFFFFFFFFFFFFFBFFFFFFFB
BFFFFFFFFFFFFFFFFFFFFFFBFFFFFFFB
BFFFFFFFFFFFFFFFFFFFFFFBFFFFFFFB
BFFFFFFFFFFFFFFFFFFFFFFBFFFFFWFB
BFFFFFFFFFFFFFFFFFFFFFFBFFFFWWFB
BFFFFFFFFFFFFFFFFFFFFFFBFFFWWWFB
BFFFFFFFFFFFFFFFFFFFFFFBFFWWWWFB
BFFFFFFFFFFFFFFFFFFFFFFBFFFFFFFB
BFFFFFFFFFFFFFFFFFFFFFFBFFFPFFFB
BFFFFFFFFFFFFFFFFFFFFFFBFFFFFFFB
BBBBBBBBBBBBBBBBBBBBBBBBBBBBBBBB
