10
300
0
20
20
BL BL BL BL BL BL BL BL BL BL BL BL BL BL BL BL BL BL BL BL 
BL co WA WA ky FF WA WA co BL BL co BL co BL co BL FF co BL 
BL J0 WA WA FF FF WA WA FF BL BL WA BL WA BL WA BL WA BL BL 
BL FF FF FF FF FF FF FF FF BL BL FF FF FF FF FF FF FF FF BL 
BL J0 WA WA WA WA WA WA FF BL BL FF FF FF FF FF FF FF FF BL 
BL FF FF FF FF FF FF FF FF BL BL FF FF FF FF FF FF FF FF BL 
BL J0 WA WA FF FF WA WA FF BL BL FF FF FF FF FF FF FF FF BL 
BL co WA WA FF FF WA WA co BL BL FF FF FF FF FF FF FF FF BL 
BL BL BL BL DR BL BL BL BL BL BL BL BL BL BL DB BL BL BL BL 
BL FF FF FF FF FF FF FF FF FF FF FF FF FF FF FF FF FF FF BL 
BL FF PS FF FF FF FF FF BL BL BL BL FF FF kr FF FF CW FF BL 
BL FF FF FF FF FF FF FF FF FF FF FF FF FF FF FF FF FF FF BL 
BL BL BL BL DG BL BL BL BL BL BL BL BL BL BL DY BL BL BL BL 
BL FF FF FF FF FF FF FF FF BL BL FF FF FF FF B0 FF FF FF BL 
BL FF BL BL BL BL BL BL co BL BL FF BD FF FF FF FF BD FF BL 
BL FF FF FF BL FF FF FF BL BL BL FF FF FF FF FF FF B0 FF BL 
BL BL BL FF FF kb BL FF FF BL BL FF B0 FF FF FF FF FF FF BL 
BL FF BL BL BL BL BL BL J0 BL BL FF BD FF B0 FF FF BD FF BL 
BL co FF FF FF FF FF FF FF BL BL FF FF FF FF FF FF FF kg BL 
BL BL BL BL BL BL BL BL BL BL BL BL BL BL BL BL BL BL BL BL 