10
20
20
BBBBBBBBBBBBBBBBBBBB
BcWWyFWWcBBcBcBcBFcB
BjWWFFWWFBBWBWBWBWBB
BFFFFFFFFBBFFFFFFFFB
BjWWWWWWFBBFFFFFFFFB
BFFFFFFFFBBFFFFFFFFB
BjWWFFWWFBBFFFFFFFFB
BcWWFFWWcBBFFFFFFFFB
BBBBRBBBBBBBBBBABBBB
BFFFFFFFFFFFFFFFFFFB
BFPFFFFFBBBBFFrFFCFB
BFFFFFFFFFFFFFFFFFFB
BBBBGBBBBBBBBBBYBBBB
BFFFFFFFFBBFFFF0FFFB
BFBBBBBBFBBFDFFFFDFB
BFFFBFFFBBBFFFFFF0FB
BFBFFbBFFBBF0FFFFFFB
BFBBBBBBFBBFDF0FFDFB
BcFFFFFFcBBFFFFFFFgB
BBBBBBBBBBBBBBBBBBBB
