23
500
1
32
32
WO WO WO WO WO WO WO WO WO WO WO WO WO WO WO WO WO WO WO WO WO WO WO WO WO WO WO WO WO WO WO WO
WO GR GR GR GR GR WO kg WO GR GR GR GR WO GR GR GR J1 GR GR GR GR WO GR GR GR GR GR GR GR co WO
WO GR BD GR BD GR WO GR GR J0 GR GR GR GR GR GR GR GR WO co GR GR WO GR WO WO WO WO WO WO WO WO
WO GR GR BD GR GR WO GR GR GR WO GR GR GR GR WO GR GR J0 GR GR GR DY GR DR GR GR GR GR GR B1 WO
WO GR BD GR BD GR WO GR GR GR GR co GR GR J2 GR GR GR GR GR WO GR WO GR WO GR WO WO WO WO GR WO
WO GR GR GR GR GR WO GR GR GR GR GR GR WO GR GR GR WO GR GR GR J2 WO GR WO GR GR GR CW GR GR WO
WO GR GR GR GR GR WO WO J1 GR GR WO GR GR GR GR GR GR GR GR GR GR WO GR WO GR GR GR GR GR GR WO
WO WO GR GR GR WO WO WO WO WO WO WO WO WO WO WO WO WO WO WO WO WO WO GR WO WO WO WO WO WO WO WO
WO J0 GR GR GR J3 WO GR GR GR GR GR WO GR GR GR GR GR WO GR GR GR GR GR WO WO WO WO co ky WO WO
WO GR GR GR GR GR WA GR GR GR GR GR WA GR GR GR GR GR GR GR GR GR GR GR GR WO WO GR GR B0 GR WO
WO GR GR GR GR GR WA GR GR GR GR GR WA GR GR GR GR GR GR GR GR GR GR GR GR WO WO GR GR GR GR WO
WO GR GR GR GR GR WA GR GR GR GR GR WA GR GR GR GR GR GR GR GR GR GR GR GR WO WO GR GR GR GR WO
WO GR GR GR GR J2 WO GR GR GR GR GR WO GR GR GR GR GR WO GR GR GR WO J2 WO WO WO GR B2 GR GR WO
WO WO GR GR GR WO WO WO GR GR GR WO WO WO WA WA WA WO WO WO WO WO WO WO WO WO WO GR WO WO GR WO
WO GR GR GR GR GR WO co GR GR GR co WO co GR GR GR GR GR GR GR V0 GR GR GR V0 V0 GR GR GR B0 WO
WO GR GR GR GR GR WO WO WO WO WO WO WO WO WO WO WO WO WO GR GR WO GR GR GR WO WO GR GR GR B2 WO
WO B1 GR GR GR GR DG GR GR GR GR GR WO GR B0 GR GR GR WO GR GR WO GR GR GR WO GR GR GR GR GR WO
WO GR GR GR GR GR WO WO WO WO WO GR WO GR GR GR B0 GR WO GR GR WO V0 WO GR WO GR GR WO WO GR WO
WO GR GR GR GR GR WO GR GR GR GR GR GR GR GR GR GR GR WO GR GR GR GR WO GR GR GR GR GR GR GR WO
WO WO GR GR GR WO WO GR GR GR GR GR GR GR GR B2 GR GR WO GR GR GR GR WO GR GR GR GR GR GR GR WO
WO GR GR GR GR GR WO GR GR WO WO WO WO WO WO WO GR GR WO co GR GR GR V0 GR GR GR GR GR GR co WO
WO GR GR GR GR GR WO GR GR WO GR GR J3 GR GR WO GR GR WO WO WO WO GR WO WO WO WO WO WO WO WO WO
WO J0 GR GR GR J2 WO GR GR WO J0 WO WO WO J2 WO GR GR GR co WO J0 GR GR WO GR GR J3 WO GR kr WO
WO GR GR GR GR GR WO GR GR WO GR co co WO GR WO GR GR WO WO WO GR GR GR GR GR GR co WO GR GR WO
WO GR GR GR GR GR WO GR GR WO GR WO co WO GR WO GR GR GR co WO GR GR GR WO J1 GR GR WO GR GR WO
WO WO GR GR GR WO WO GR GR WO GR WO co co J2 WO GR GR WO WO WO WO GR WO WO WO WO WO WO GR WO WO
WO GR GR GR GR GR WO GR GR WO GR WO WO WO GR WO GR GR GR co WO GR GR GR WO GR GR GR WO GR GR WO
WO GR GR GR GR GR WO GR GR WO J1 GR GR J1 GR WO GR GR WO WO WO GR GR GR GR GR GR GR WO GR GR WO
WO GR GR PS GR J2 WO GR GR WO WO WO GR WO WO WO GR GR GR co WO GR GR J2 WO GR GR J2 WO J1 GR WO
WO GR GR GR GR GR WO GR GR GR GR GR GR GR GR GR GR GR WO WO WO WO GR WO WO WO GR WO WO WO GR WO
WO GR GR GR GR GR WO GR GR GR GR GR GR GR GR GR GR GR GR co WO co GR co WO co GR GR GR GR GR WO
WO WO WO WO WO WO WO WO WO WO WO WO WO WO WO WO WO WO WO WO WO WO WO WO WO WO WO WO WO WO WO WO 