0
500
3
16
16
SB SB SB SB SB SB SB SB SB SB SB SB SB SB SB SB 
SB SN SN SN SB SN SN SN SN SN SN SN SN SN SB SB
SB SN PS SN SB SN SB SN SB V0 SB SB SB SN SN SB
SB SN SN SN SB SN SB SN BD SN SB SN SN SN SN SB
SB SN SB SB SB SN SB SB SB SN SB BD SB SN SN SB
SB SN SB J0 SB SN V0 SN SN SN SN SN V0 SN SN SB
SB SN SB SN V0 SN SB BD SB SN SB SB SB SN SN SB
SB SN SB SN SB SN SB SN SN SN BD SN SN SN SN SB
SB SN SN SN SB SN SB SB SB V0 SB SB SB SN SN SB
SB SB SB SB SB SN SN SN SN SN SN SN V0 SN SN SB
SB SN SN SN SB WA SB SB SB SB SB SB SB SB SB SB
SB SN SN SN SB WA SB SN SN SN SN SN SN SN SN SB
SB SN kb SB SB WA SB SN SN B0 SN B0 SN SN SN SB
SB SN SB SB SB WA SB SN SN SN SN SN SN SN CW SB
SB SN SN SN SN SN SN SN B2 SN B2 SN B2 SN SN SB
SB SB SB SB SB SB SB SB SB SB SB SB SB SB SB SB 