12
300
4
16
16
BR CR BR CR BR BR BR BR BR BR BR BR BR BR BR BR 
BR co BR CR DD DD DD BR CR co CR DD co BR co BR
CR DD BR DD DD BR DD DD DD DD DD DD BR DD DD BR
BR DD BR DD CR BR BR co CR CR CR BR BR DD BR BR
BR DD BR DD DD DD co BR BR DD DD DD BR DD DD BR
BR DD DD DD CR CR CR CW BR DD CR co CR CR DD BR
BR CR DD BR DD DD DD DD CR DD BR BR BR DD DD BR
CR co DD BR DD CR BR BR BR DD DD BR DD DD CR BR
BR BR DD DD DD DD BR PS BR CR DD BR DD CR co BR
BR co BR DD BR BR BR DD BR BR DD BR DD DD DD BR
CR DD BR DD DD BR DD DD DD BR DD BR DD BR DD BR
BR DD CR BR DD DD DD CR DD DD DD CR DD BR DD BR
BR DD DD DD BR BR DD DD DD BR DD BR DD BR DD BR
BR DD BR DD DD BR BR DD BR BR BR DD DD CR DD BR
CR DD co BR DD DD DD DD DD DD DD DD CR co DD BR
CR CR BR BR BR BR BR BR BR BR CR BR BR BR BR BR 